1111111111111111111
1000001000000010001
1011101011101010101
1010100000101010101
1010111111101010111
1000000010001010001
1011111110111011101
1010000000100000001
1010111111101111101
1010000010001000101
1011111011111010101
1010001000000010101
1110101011111110111
1000101000000010001
1011101111101111101
1010101000101000001
1010101010111011101
0010000010000010001
1111111111111111111